0001111111
1111000001
1000040201
1000333001
1041141141
1000000001
1000030001
1003040001
1111000010
0001111110
9540
9420
9440
9240
8760